####################################################
▓▓▓▓▓▓▓▓▓▓▓▓▓▓▓▓▓▓▓▓▓▓▓▓▓▓▓▓▓▓▓▓▓▓▓▓▓▓▓▓▓▓▓▓▓▓▓▓▓▓▓▓#
▓▓▓▓▓▓▓▓▓▓▓▓▓▓▓▓▓▓▓▓▓▓▓▓▓▓▓▓▓▓▓▓▓▓▓▓▓▓▓▓▓▓▓▓▓▓▓▓▓▓▓▓#
▓▓▓▓    ▓▓▓▓                            ▓▓▓▓    ▓▓▓▓#
▓▓▓▓    ▓▓▓▓                            ▓▓▓▓    ▓▓▓▓#
▓▓▓▓            ████▓▓▓▓████            ▓▓▓▓    ▓▓▓▓#
▓▓▓▓            ████▓▓▓▓████            ▓▓▓▓    ▓▓▓▓#
▓▓▓▓                        ▓▓▓▓		        ▓▓▓▓#
▓▓▓▓▓▓▓▓▓▓▓▓                ▓▓▓▓                ▓▓▓▓#
▓▓▓▓▓▓▓▓▓▓▓▓▓▓▓▓    ████    ▓▓▓▓                ▓▓▓▓#
▓▓▓▓▓▓▓▓▓▓▓▓▓▓▓▓    ████    ▓▓▓▓                ▓▓▓▓#
▓▓▓▓▓▓▓▓▓▓▓▓▓▓▓▓                                ▓▓▓▓#
▓▓▓▓▓▓▓▓▓▓▓▓▓▓▓▓                        ▓▓▓▓    ▓▓▓▓#
▓▓▓▓    ▓▓▓▓    ████▓▓▓▓████            ▓▓▓▓    ▓▓▓▓#
▓▓▓▓    ▓▓▓▓    ████▓▓▓▓████            ▓▓▓▓    ▓▓▓▓#
▓▓▓▓    ▓▓▓▓                            ▓▓▓▓    ▓▓▓▓#
▓▓▓▓    ▓▓▓▓                            ▓▓▓▓    ▓▓▓▓#
▓▓▓▓    ▓▓▓▓    ▓▓▓▓▓███████████▓▓▓▓▓▓▓▓▓▓▓▓    ▓▓▓▓#
▓▓▓▓    ▓▓▓▓    ▓▓▓▓▓███████████▓▓▓▓▓▓▓▓▓▓▓▓    ▓▓▓▓#
▓▓▓▓    ▓▓▓▓		                            ▓▓▓▓#
▓▓▓▓    ▓▓▓▓		                            ▓▓▓▓#
▓▓▓▓    ▓▓▓▓▓▓▓▓▓▓▓▓    ▓▓▓▓▓▓▓▓▓▓▓▓▓▓▓▓▓▓▓▓    ▓▓▓▓#
▓▓▓▓    ▓▓▓▓▓▓▓▓▓▓▓▓    ▓▓▓▓▓▓▓▓▓▓▓▓▓▓▓▓▓▓▓▓    ▓▓▓▓#
▓▓▓▓                    ▓▓▓▓                    ▓▓▓▓#
▓▓▓▓                    ▓▓▓▓                    ▓▓▓▓#
▓▓▓▓▓▓▓▓▓▓▓▓▓▓▓▓▓▓▓▓▓▓▓▓▓▓▓▓▓▓▓▓▓▓▓▓▓▓▓▓▓▓▓▓▓▓▓▓▓▓▓▓#
▓▓▓▓▓▓▓▓▓▓▓▓▓▓▓▓▓▓▓▓▓▓▓▓▓▓▓▓▓▓▓▓▓▓▓▓▓▓▓▓▓▓▓▓▓▓▓▓▓▓▓▓#
####################################################