##########################
#        X         #
# XXX    X  XX XX X#
# XW  XX X  X  X   #
# XW  XX X  X  X X #
# XW  XX    X    X #
# XW  XX X XX XX X #
#    X    X        #
##########################