####################################################
▓▓▓▓▓▓▓▓▓▓▓▓▓▓▓▓▓▓▓▓▓▓▓▓▓▓▓▓▓▓▓▓▓▓▓▓▓▓▓▓▓▓▓▓▓▓▓▓▓▓▓▓#
▓▓▓▓▓▓▓▓▓▓▓▓▓▓▓▓▓▓▓▓▓▓▓▓▓▓▓▓▓▓▓▓▓▓▓▓▓▓▓▓▓▓▓▓▓▓▓▓▓▓▓▓#
▓▓▓▓    ▓▓▓▓                            ▓▓▓▓    ▓▓▓▓#
▓▓▓▓    ▓▓▓▓                            ▓▓▓▓    ▓▓▓▓#
▓▓▓▓    ▓▓▓▓    ▓▓▓▓▓▓▓▓████    ▓▓▓▓    ▓▓▓▓    ▓▓▓▓#
▓▓▓▓    ▓▓▓▓    ▓▓▓▓▓▓▓▓████    ▓▓▓▓    ▓▓▓▓    ▓▓▓▓#
▓▓▓▓            ▓▓▓▓            ▓▓▓▓            ▓▓▓▓#
▓▓▓▓            ▓▓▓▓            ▓▓▓▓            ▓▓▓▓#
▓▓▓▓▓▓▓▓▓▓▓▓▓▓▓▓████    ████████████▓▓▓▓▓▓▓▓    ▓▓▓▓#
▓▓▓▓▓▓▓▓▓▓▓▓▓▓▓▓████    ████████████▓▓▓▓▓▓▓▓    ▓▓▓▓#
▓▓▓▓            ▓▓▓▓            ▓▓▓▓    ▓▓▓▓    ▓▓▓▓#
▓▓▓▓            ▓▓▓▓            ▓▓▓▓    ▓▓▓▓    ▓▓▓▓#
▓▓▓▓    ▓▓▓▓    ▓▓▓▓▓▓▓▓████    ▓▓▓▓    ▓▓▓▓    ▓▓▓▓#
▓▓▓▓    ▓▓▓▓    ▓▓▓▓▓▓▓▓████    ▓▓▓▓    ▓▓▓▓    ▓▓▓▓#
▓▓▓▓    ▓▓▓▓                    ▓▓▓▓            ▓▓▓▓#
▓▓▓▓    ▓▓▓▓                    ▓▓▓▓            ▓▓▓▓#
▓▓▓▓    ▓▓▓▓    ▓▓▓▓▓███████████▓▓▓▓▓▓▓▓▓▓▓▓▓▓▓▓▓▓▓▓#
▓▓▓▓    ▓▓▓▓    ▓▓▓▓▓███████████▓▓▓▓▓▓▓▓▓▓▓▓▓▓▓▓▓▓▓▓#
▓▓▓▓    ▓▓▓▓    ▓▓▓▓                            ▓▓▓▓#
▓▓▓▓    ▓▓▓▓    ▓▓▓▓                            ▓▓▓▓#
▓▓▓▓    ▓▓▓▓▓▓▓▓▓▓▓▓    ▓▓▓▓▓▓▓▓▓▓▓▓▓▓▓▓▓▓▓▓    ▓▓▓▓#
▓▓▓▓    ▓▓▓▓▓▓▓▓▓▓▓▓    ▓▓▓▓▓▓▓▓▓▓▓▓▓▓▓▓▓▓▓▓    ▓▓▓▓#
▓▓▓▓                    ▓▓▓▓                    ▓▓▓▓#
▓▓▓▓                    ▓▓▓▓                    ▓▓▓▓#
▓▓▓▓▓▓▓▓▓▓▓▓▓▓▓▓▓▓▓▓▓▓▓▓▓▓▓▓▓▓▓▓▓▓▓▓▓▓▓▓▓▓▓▓▓▓▓▓▓▓▓▓#
▓▓▓▓▓▓▓▓▓▓▓▓▓▓▓▓▓▓▓▓▓▓▓▓▓▓▓▓▓▓▓▓▓▓▓▓▓▓▓▓▓▓▓▓▓▓▓▓▓▓▓▓#
####################################################